XXXXXXXXXXXXXXXXXXX
X........X........X
X.XX.XXX.X.XXX.XX.X
X.................X
X.XX.X.XXXXX.X.XX.X
X....X.......X....X
XXXX.XXXXXXX.XXXXXX
...X.X.......X.X...
XXXX.X.XXrXX.X.XXXX
X.................X
XXXX.X.XXXXX.X.XXXX
...X.X..bop..X.X...
XXXX.X.XXXXX.X.XXXX
X........X........X
X.XX.XXX.X.XXX.XX.X
X..X...........X..X
XX.X.X.XXXXX.X.X.XX
X....X...X...X....X
X.XXXXXX.X.XXXXXX.X
X........P........X
XXXXXXXXXXXXXXXXXXX