XXXXXXXXXXXXXXXXXXX
X........X........X
X.XX.XXX.X.XXX.XX.X
X.................X
X.XX.X.XXXXX.X.XX.X
X....X.......X....X
XXXX.XXXXXXX.XXXXXX
000X.X.......X.X000
XXXX.X.XXrXX.X.XXXX
X.................X
XXXX.X.XXXXX.X.XXXX
000X.X..bop..X.X000
XXXX.X.XXXXX.X.XXXX
X........X........X
X.XX.XXX.X.XXX.XX.X
X..X...........X..X
XX.X.X.XXXXX.X.X.XX
X....X...X...X....X
X.XXXXXX.X.XXXXXX.X
X........P........X
XXXXXXXXXXXXXXXXXXX